NO assets/tile065.xpm
SO assets/tile110.xpm
WE assets/tile065.xpm
EA assets/tile110.xpm

C 100,100,160
F 15,111,154

11111111111111111
10000000000000001
10100000100000101
10000000000000001
100010A0100A10001
10000000000000001
10101010N01010101
100000000A0000001
10001000100100001
10000000000000001
10100000100001001
10000000000000001
11111111111111111
