NO ./assets/tile065.xpm
SO ./assets/tile068.xpm
WE ./assets/tile073.xpm
EA ./assets/tile085.xpm

F 220,100,0
C 225,30,0

1111111111
1100000001
1010000101
1001001001
1000E0A001
1001O01101
1011001001
1000000001
1111111111
