NO ./assets/tile065.xpm
SO ./assets/tile068.xpm
WE ./assets/tile073.xpm
EA ./assets/tile085.xpm

F 220,100,0
C 225,30,0

                        1 1
                      1111111111
                     11000001001
      111            111c1C11001
111111101111         10000000001
1S00100000011        1000AAA0001
1000O00000001111111111000A0A0001
111C10001000O00000000o000AAA00011
  1011101000111cc1111100000000001
  101 100001000000000110000000001
  101 100001010000010111CC111o111
111c111000110000A000010000001011 1111111
10o0O0o000110010A01001000000100111000001
1011111000O00100A0000O000000100C00000001
1001  100010000AAA0001000000100c00000001
11c1  1C11100100A0010100000c1c0111000001
11011110111000100010010000100011 1111111
1000000001110000000011000011011     11
10010100011111000001111C1111c11
10A0010A01  11100011000000000011
1000011001   111c1110000000000011
10000A000111111000111100000101001
101001A00cOcOo0A0A0cCc00001110011
10000001011111000001111010000001
1111111111   11A0A11  1111000101
              11011      1000001
               111       1111111
